111111111111111111111111111111111111111111111111111111
1C1111000000000CCCCCCCCCCCCCCCCCC000000000000000000001
1000000000000000000000C0000000000000000000000000000001
1000C0000100C0000000C0C0000010000000C00000000E00000001
1000000001000000000000C0000010000000000000000000000001
1000C000010000000000C0C0011110000000000000000000000001
1000000000P00011100000C0000000000000C00000000C00000001
1000000000000000000000C0000000000000000000000000000001
1000C0000000000000000000000000000000000000000C00000001
111111111111111111111111111111111111111111111111111111