11111111111
10000E00001
100C0000C01
1C1000C0001
1110P0001C11
100C00001C1
11111111111