11111111111
10000000001
100C0000C01
1C10P0C0001
111000001C1
100C00001C1
11111111111