11111111111
10000E00001
10000000001
10100000001
1110P000101
10000000101
11111111111